We	PP	we
find	VVP	find
that	IN/that	that
in	IN	in
fact	NN	fact
these	DT	these
people	NNS	people
are	VBP	be
the	DT	the
most	RBS	most
exposed	VVN	expose
to	TO	to
media	NNS	medium
not	RB	not
to	TO	to
mension	NN	mension
the	DT	the
fact	NN	fact
that	IN/that	that
there	EX	there
is	VBZ	be
forever	RB	forever
AIDS	NP	AIDS
awareness	NN	awareness
campaigns	NNS	campaign
launged	VVN	launged
through	IN	through
out	IN	out
the	DT	the
county	NN	county
.	SENT	.